==================================================  
-----------------=======---------------------=  
=----======--========-------=----==============--=  
====------------=-------=--======-=------------=-=  
=--=----------------=---=--------------=======---=  
=--=------------=---=---=============--=-------=-=  
=---------------=---=---=--------------=---------=  
=--==============---=---==========-============--=  
=--==---------------------==------------------=--=  
=---==========--===============================--=  
=------------=--=-------------------------=---====  
=--=---------==-===-===----=---=--========-------=  
=--=------------------============-=---------=---=  
=--========--=====--===------------=-----=====---=  
=---------------=------------------------=-------=  
=-----------------======================-=-------=  
======--------=--=-----------=-----------=-------=  
=----=========--======-=======-------------------=  
=-----------------------=----------------=-------8  
==================================================  
